Rk -- Rank
Pos -- Position
Age -- Player's age on February 1 of the season
Tm -- Team
G -- Games
GS -- Games Started
MP -- Minutes Played Per Game
FG -- Field Goals Per Game
FGA -- Field Goal Attempts Per Game
FG% -- Field Goal Percentage
3P -- 3-Point Field Goals Per Game
3PA -- 3-Point Field Goal Attempts Per Game
3P% -- FG% on 3-Pt FGAs.
2P -- 2-Point Field Goals Per Game
2PA -- 2-Point Field Goal Attempts Per Game
2P% -- FG% on 2-Pt FGAs.
eFG% -- Effective Field Goal Percentage
This statistic adjusts for the fact that a 3-point field goal is worth one more point than a 2-point field goal.
FT -- Free Throws Per Game
FTA -- Free Throw Attempts Per Game
FT% -- Free Throw Percentage
ORB -- Offensive Rebounds Per Game
DRB -- Defensive Rebounds Per Game
TRB -- Total Rebounds Per Game
AST -- Assists Per Game
STL -- Steals Per Game
BLK -- Blocks Per Game
TOV -- Turnovers Per Game
PF -- Personal Fouls Per Game
PTS -- Points Per Game